-T-T-T-T-
-l-c-----
-c-----l-
---l---c-
-b-----b-
-----c---
---------
-----l---
---b-b---
