dFdDfDfFd
bFbUdUdFb
bFuDbEbFb
uFdBbDuFu
eEbLbUdEe
eEbUuFbEe
ePbEeEbPe
dDbEeEbFd
bBbEeEbFb
uUbPEPbDb
eEbDdDbEe
eEuUuUuEe
ePeEeEePe