-T-T-T-T-
---t-p---
-p-----t-
-b-b-b-b-
---------
---------
---------
-T-----T-
-t-----p-
-b-----b-