---T-T-T-
---------
-T---l-l-
---------
-l-----p-
---l-p---
-------b-
-p-p-----
---------
-b-b-b---
