dFdDdFdFd
lElLlElEl
uDbLbDbFb
eLbUbLlEl
dBbElLbDu
lLbFbUbLe
lLlElEbBd
bUbFbFbLl
lElElElLl
uFuFuFuUu
eEeEeEeEe
eEeEeEeEe
eEeEeEeEe
pPpPpPpPp