dDdDdDdDd
bBbBbLlLl
bBbLbBbBb
lLbBbLbBb
uUuBbBuUu
eEeLbBfEe
eEfBbLeEe
eEeLbBfEe
eEfUbUfEe
pPpElEpPp
eEeEuEeEe
eEpPpPpEe